0304 0414 1424 2434 
0313 1323 2333 3343 
5253 
5262 6272 7282 8283 8384 8485 8586 8687 8788 8889 8999 
5556 5666 6676 7686 8687 8788 8889 8999 
5564 6473 7382 8283 8384 8485 8586 8687 8788 8889 8999 
3443 
3444 4454 
5455 
5464 6473 7382 8283 8384 8485 8586 8687 8788 8889 8999 
4352 
4353 
5354 
5363 6373 7382 8283 8384 8485 8586 8687 8788 8889 8999 
0001 0102 0203 
